Key mapping:
a -> u
b -> i
c -> m
d -> S
e -> c
f -> h
g -> B
h -> Q
i -> v
j -> W
k -> j
l -> r
m -> K
n -> E
o -> J
p -> t
q -> x
r -> q
s -> Y
t -> P
u -> w
v -> R
w -> X
x -> L
y -> p
z -> d
A -> M
B -> a
C -> k
D -> s
E -> b
F -> V
G -> e
H -> T
I -> C
J -> F
K -> O
L -> D
M -> f
N -> A
O -> z
P -> l
Q -> U
R -> N
S -> y
T -> g
U -> n
V -> H
W -> G
X -> o
Y -> I
Z -> Z
kqptPJBqutQp vY hwE uES mQurrcEBvEB!